* * * * * * * * * * 
1 1 1 1 1 1 1 1 1 * 
9 1 1 1 1 1 1 1 1 * 
* 1 1 1 1 1 1 1 1 * 
* 1 1 1 1 1 1 1 1 * 
* 1 1 1 1 1 1 1 1 * 
* 1 1 1 1 1 1 1 1 * 
* 1 1 1 1 1 1 1 1 * 
* 1 1 1 1 1 1 1 1 * 
* * * * * * * * * * 


The exit found at coordinate: (2,0)