* * * * * * 
1 1 1 1 1 * 
* * * * 1 * 
* 1 1 * * * 
* * * 1 1 1 
1 1 * 1 * 9 
* * * 1 * 1 
* 1 1 1 * 1 
* 1 * * * * 
* * * 1 0 1 


The exit found at coordinate: (5,5)