* 1 1 1 * 1 * * * * 
* * * * * 1 * 1 1 * 
1 1 * 1 1 * * 1 * * 
* 1 * 1 1 * 1 1 * 1 
* * * * 1 * * 1 * * 
1 1 1 * 1 * 1 1 1 * 
* * * * 1 * 1 0 1 * 
* 1 1 * * * 1 0 1 * 
* 1 1 0 1 1 1 0 1 * 
* 1 0 0 0 0 1 1 1 9 


The exit found at coordinate: (9,9)